03 03 03 03 03 03 03 03 03 03 03 03 03 03 03 03 03 03 03 03 03 03 03 03 03 03 03 03 03 03 03 03
03 40 03 40 03 40 40 40 03 40 03 03 03 40 03 03 03 40 40 40 03 03 03 03 03 03 03 03 03 03 03 03
03 40 03 40 03 40 03 03 03 40 03 03 03 40 03 03 03 40 03 40 03 03 03 03 03 03 03 03 03 03 03 03
03 40 40 40 03 40 40 40 03 40 03 03 03 40 03 03 03 40 03 40 03 03 03 03 03 03 03 03 03 03 03 03
03 40 03 40 03 40 03 03 03 40 03 03 03 40 03 03 03 40 03 40 03 03 03 03 03 03 03 03 03 03 03 03
03 40 03 40 03 40 40 40 03 40 40 40 03 40 40 40 03 40 40 40 03 03 03 03 03 03 03 03 03 03 03 03
03 03 03 03 03 03 03 03 03 03 03 03 03 03 03 03 03 03 03 03 03 03 03 03 03 03 03 03 03 03 03 03
03 40 03 40 03 40 40 40 03 40 40 03 03 40 03 03 03 40 40 03 03 03 03 03 03 03 03 03 03 03 03 03
03 40 03 40 03 40 03 40 03 40 03 40 03 40 03 03 03 40 03 40 03 03 03 03 03 03 03 03 03 03 03 03
03 40 03 40 03 40 03 40 03 40 40 03 03 40 03 03 03 40 03 40 03 03 03 03 03 03 03 03 03 03 03 03
03 40 40 40 03 40 03 40 03 40 03 40 03 40 03 03 03 40 03 40 03 03 03 03 03 03 03 03 03 03 03 03
03 40 03 40 03 40 40 40 03 40 03 40 03 40 40 40 03 40 40 03 03 03 03 03 03 03 03 03 03 03 03 03
03 03 03 03 03 03 03 03 03 03 03 03 03 03 03 03 03 03 03 03 03 03 03 03 03 03 03 03 03 03 03 03
03 03 03 03 03 03 03 03 03 03 03 03 03 03 03 03 03 03 03 03 03 03 03 03 03 03 03 03 03 03 03 03
03 03 03 03 03 03 03 03 03 03 03 03 03 03 03 03 03 03 03 03 03 03 03 03 03 03 03 03 03 03 03 03
03 03 03 03 03 03 03 03 03 03 03 03 03 03 03 03 03 03 03 03 03 03 03 03 03 03 03 03 03 03 03 03
03 03 03 03 03 03 03 03 03 03 03 03 03 03 03 03 03 03 03 03 03 03 03 03 03 03 03 03 03 03 03 03
03 03 03 03 03 03 03 03 03 03 03 03 03 03 03 03 03 03 03 03 03 03 03 03 03 03 03 03 03 03 03 03
