03 03 03 03 03 03 03 03 03 03 03 03 03 03 03 03 03 03 03 03 03 03 03 03 03 03 03 03 03 03 03 03
03 03 03 03 03 03 03 03 03 03 03 03 03 03 03 03 03 03 03 03 03 03 03 03 03 03 03 03 03 03 03 03
03 03 03 03 03 03 03 03 03 03 03 03 03 03 03 03 03 03 03 03 03 03 03 03 03 03 03 03 03 03 03 03
03 03 03 03 03 03 03 03 03 03 03 03 03 03 03 03 03 03 03 03 03 03 03 03 03 03 03 03 03 03 03 03
03 03 03 03 03 03 03 80 80 80 80 80 80 80 80 80 80 80 80 80 80 80 80 80 03 03 03 03 03 03 03 03
03 03 03 03 03 03 03 80 00 00 00 00 00 00 00 00 00 00 00 00 00 00 00 80 03 03 03 03 03 03 03 03
03 03 03 03 03 03 03 80 00 00 00 00 00 00 00 00 00 00 00 00 00 00 00 80 03 03 03 03 03 03 03 03
03 03 03 03 03 03 03 80 00 00 00 00 00 00 00 00 00 00 00 00 00 00 00 80 03 03 03 03 03 03 03 03
03 03 03 03 03 03 03 80 00 00 00 00 00 00 00 00 00 00 00 00 00 00 00 80 03 03 03 03 03 03 03 03
03 03 03 03 03 03 03 80 00 00 00 00 00 00 00 00 00 00 00 00 00 00 00 80 03 03 03 03 03 03 03 03
03 03 03 03 03 03 03 80 00 00 00 00 00 00 00 00 00 00 00 00 00 00 00 80 03 03 03 03 03 03 03 03
03 03 03 03 03 03 03 80 00 00 00 00 00 00 00 00 00 00 00 00 00 00 00 80 03 03 03 03 03 03 03 03
03 03 03 03 03 03 03 80 00 00 00 00 00 00 00 00 00 00 00 00 00 00 00 80 03 03 03 03 03 03 03 03
03 03 03 03 03 03 03 80 80 80 80 80 80 80 80 80 80 80 80 80 80 80 80 80 03 03 03 03 03 03 03 03
03 03 03 03 03 03 03 03 03 03 03 03 03 03 03 03 03 03 03 03 03 03 03 03 03 03 03 03 03 03 03 03
03 03 03 03 03 03 03 03 03 03 03 03 03 03 03 03 03 03 03 03 03 03 03 03 03 03 03 03 03 03 03 03
03 03 03 03 03 03 03 03 03 03 03 03 03 03 03 03 03 03 03 03 03 03 03 03 03 03 03 03 03 03 03 03
03 03 03 03 03 03 03 03 03 03 03 03 03 03 03 03 03 03 03 03 03 03 03 03 03 03 03 03 03 03 03 03
